11111111111111111111111
1G000001000000000000001
101011111111111111111C1
10100000000000000010101
10101111111111111110001
10101000000100000010101
10101011111111111000101
10100010000000001010101
10111010111111101010101
10101110100000101010111
10101010100000101011101
10101010100E00101010101
10101010100000100010101
10100010100000101010101
10101010111011101010101
10101010000000001010101
10101011111111111110001
10000000000000000010101
10101111111011111110101
10100010000000000000101
10111111111111111111101
10001000000000000000001
11111111111P11111111111
11111111111111111111111